1111111111111
10C000N000001
10010000000C1
1001011111001
1P0011E000001
1000110000001
1111111111111
